size 13 11

9 1 5 5 5 1 5 1 5 1 5 5 3
10 12 3 9 3 10 9 4 3 8 5 3 10
10 9 6 10 12 2 12 3 10 12 3 10 10
8 2 9 0 3 8 5 6 8 5 6 12 2
10 10 10 10 10 8 1 1 4 5 5 3 10
10 8 2 10 8 2 10 8 5 5 5 0 2
10 10 10 10 10 8 4 4 1 5 5 6 10
12 2 12 0 6 8 5 3 8 5 3 9 6
11 12 3 10 9 2 9 6 10 9 6 10 11
10 9 6 12 6 10 12 1 2 8 5 6 10
14 12 5 5 5 4 5 4 5 6 13 5 6